Id,SleepDay,TotalSleepRecords,TotalMinutesAsleep,TotalTimeInBed,BedtimeRoutine,SleepQuality,TotalSteps,SedentaryMinutes,ModeratelyActiveMinutes
1503960366,4/12/2016,1,327,346,19,1.058103976,13162,728,38
1503960366,4/13/2016,2,384,407,23,1.059895833,10735,776,19
1503960366,4/15/2016,1,412,442,30,1.072815534,9762,726,34
1503960366,4/16/2016,2,340,367,27,1.079411765,12669,773,10
1503960366,4/17/2016,1,700,712,12,1.017142857,9705,539,20
1503960366,4/19/2016,1,304,320,16,1.052631579,15506,775,31
1503960366,4/20/2016,1,360,377,17,1.047222222,10544,818,12
1503960366,4/21/2016,1,325,364,39,1.12,9819,838,8
1503960366,4/23/2016,1,361,384,23,1.063711911,14371,732,21
1503960366,4/24/2016,1,430,449,19,1.044186047,10039,709,5
1503960366,4/25/2016,1,277,323,46,1.166064982,15355,814,14
1503960366,4/26/2016,1,245,274,29,1.118367347,13755,833,23
1503960366,4/28/2016,1,366,393,27,1.073770492,13154,782,28
1503960366,4/29/2016,1,341,354,13,1.038123167,11181,815,12
1503960366,4/30/2016,1,404,425,21,1.051980198,14673,712,34
1503960366,5/1/2016,1,369,396,27,1.073170732,10602,730,35
1503960366,5/2/2016,1,277,309,32,1.115523466,14727,798,15
1503960366,5/3/2016,1,273,296,23,1.084249084,15103,816,24
1503960366,5/5/2016,1,247,264,17,1.068825911,14070,857,24
1503960366,5/6/2016,1,334,367,33,1.098802395,12159,754,6
1503960366,5/7/2016,1,331,349,18,1.054380665,11992,833,46
1503960366,5/8/2016,1,594,611,17,1.028619529,10060,574,8
1503960366,5/9/2016,1,338,342,4,1.01183432,12022,835,11
1503960366,5/10/2016,1,383,403,20,1.052219321,12207,746,31
1503960366,5/11/2016,1,285,306,21,1.073684211,12770,669,23
1644430081,4/29/2016,1,119,127,8,1.067226891,3176,1193,0
1644430081,4/30/2016,1,124,142,18,1.14516129,18213,816,71
1644430081,5/2/2016,1,796,961,165,1.207286432,3758,682,7
1644430081,5/8/2016,1,137,154,17,1.124087591,6724,991,0
1844505072,4/15/2016,1,644,961,317,1.492236025,3844,527,0
1844505072,4/30/2016,1,722,961,239,1.331024931,4014,218,0
1844505072,5/1/2016,1,590,961,371,1.628813559,2573,585,7
1927972279,4/12/2016,3,750,775,25,1.033333333,678,734,0
1927972279,4/13/2016,1,398,422,24,1.060301508,356,986,0
1927972279,4/15/2016,2,475,499,24,1.050526316,980,941,0
1927972279,4/26/2016,1,296,315,19,1.064189189,3761,1058,0
1927972279,4/28/2016,1,166,178,12,1.072289157,1675,1167,0
2026352035,4/12/2016,1,503,546,43,1.085487078,4414,706,8
2026352035,4/13/2016,1,531,565,34,1.064030132,4993,663,0
2026352035,4/14/2016,1,545,568,23,1.042201835,3335,653,0
2026352035,4/15/2016,1,523,573,50,1.095602294,3821,687,0
2026352035,4/16/2016,1,524,567,43,1.082061069,2547,728,0
2026352035,4/17/2016,1,437,498,61,1.139588101,838,1053,0
2026352035,4/19/2016,1,498,540,42,1.084337349,2424,785,0
2026352035,4/20/2016,1,461,510,49,1.106290672,7222,623,0
2026352035,4/21/2016,1,477,514,37,1.077568134,2467,749,0
2026352035,4/22/2016,1,520,545,25,1.048076923,2915,712,0
2026352035,4/23/2016,1,522,554,32,1.061302682,12357,458,0
2026352035,4/24/2016,1,555,591,36,1.064864865,3490,704,0
2026352035,4/25/2016,1,506,531,25,1.049407115,6017,821,0
2026352035,4/27/2016,1,508,545,37,1.072834646,6088,586,0
2026352035,4/28/2016,1,513,545,32,1.062378168,6375,626,0
2026352035,4/29/2016,1,490,510,20,1.040816327,7604,492,0
2026352035,4/30/2016,1,573,607,34,1.059336824,4729,594,0
2026352035,5/1/2016,1,527,546,19,1.036053131,3609,716,0
2026352035,5/2/2016,1,511,543,32,1.062622309,7018,716,0
2026352035,5/4/2016,1,538,560,22,1.040892193,6564,530,0
2026352035,5/5/2016,1,468,485,17,1.036324786,12167,479,0
2026352035,5/6/2016,1,524,548,24,1.045801527,8198,511,0
2026352035,5/7/2016,1,511,521,10,1.019569472,4193,665,0
2026352035,5/8/2016,1,541,568,27,1.049907579,5528,610,0
2026352035,5/9/2016,1,531,556,25,1.047080979,10685,543,0
2026352035,5/10/2016,1,357,380,23,1.06442577,254,1002,0
2026352035,5/11/2016,1,523,553,30,1.057361377,8580,569,0
2026352035,5/12/2016,1,456,485,29,1.063596491,8891,330,0
2320127002,4/23/2016,1,61,69,8,1.131147541,5079,1129,0
2347167796,4/13/2016,1,467,531,64,1.137044968,10352,676,32
2347167796,4/14/2016,1,445,489,44,1.098876404,10129,705,48
2347167796,4/15/2016,1,452,504,52,1.115044248,10465,720,24
2347167796,4/17/2016,1,556,602,46,1.082733813,5472,508,7
2347167796,4/18/2016,1,500,557,57,1.114,8247,678,16
2347167796,4/19/2016,1,465,514,49,1.105376344,6711,648,7
2347167796,4/21/2016,1,460,484,24,1.052173913,10080,761,26
2347167796,4/22/2016,1,405,461,56,1.138271605,7804,781,27
2347167796,4/23/2016,1,374,386,12,1.032085561,16901,591,35
2347167796,4/24/2016,1,442,459,17,1.038461538,9471,584,0
2347167796,4/25/2016,1,433,471,38,1.087759815,9482,653,11
2347167796,4/26/2016,1,436,490,54,1.123853211,5980,732,0
2347167796,4/27/2016,1,448,499,51,1.113839286,11423,623,9
2347167796,4/28/2016,1,408,450,42,1.102941176,5439,764,0
2347167796,4/29/2016,1,411,473,62,1.150851582,42,2,0
3977333714,4/12/2016,1,274,469,195,1.711678832,8856,777,19
3977333714,4/13/2016,2,295,456,161,1.545762712,10035,754,46
3977333714,4/14/2016,1,291,397,106,1.364261168,7641,801,23
3977333714,4/15/2016,1,424,556,132,1.311320755,9010,644,42
3977333714,4/16/2016,1,283,510,227,1.802120141,13459,663,83
3977333714,4/17/2016,1,381,566,185,1.485564304,10415,600,58
3977333714,4/18/2016,2,412,522,110,1.266990291,11663,605,95
3977333714,4/19/2016,1,219,395,176,1.803652968,12414,738,67
3977333714,4/20/2016,2,152,305,153,2.006578947,11658,845,98
3977333714,4/21/2016,1,332,512,180,1.542168675,6093,712,0
3977333714,4/22/2016,1,355,476,121,1.34084507,8911,731,12
3977333714,4/23/2016,1,235,372,137,1.582978723,12058,724,92
3977333714,4/24/2016,1,310,526,216,1.696774194,14112,660,95
3977333714,4/25/2016,1,262,467,205,1.782442748,11177,781,9
3977333714,4/26/2016,1,250,371,121,1.484,11388,797,95
3977333714,4/27/2016,1,349,540,191,1.547277937,7193,714,10
3977333714,4/28/2016,1,261,423,162,1.620689655,7114,804,8
3977333714,4/29/2016,1,333,478,145,1.435435435,10645,744,32
3977333714,4/30/2016,1,237,382,145,1.611814346,13238,687,52
3977333714,5/1/2016,1,383,626,243,1.634464752,10414,691,40
3977333714,5/2/2016,1,230,384,154,1.669565217,16520,713,143
3977333714,5/3/2016,1,292,500,208,1.712328767,14335,594,41
3977333714,5/4/2016,1,213,336,123,1.577464789,13559,852,96
3977333714,5/5/2016,1,318,480,162,1.509433962,12312,680,88
3977333714,5/6/2016,1,323,512,189,1.585139319,11677,676,55
3977333714,5/7/2016,1,237,443,206,1.869198312,11550,703,86
3977333714,5/8/2016,2,259,456,197,1.760617761,13585,688,116
3977333714,5/10/2016,1,312,452,140,1.448717949,13072,676,115
4020332650,4/12/2016,1,501,541,40,1.079840319,8539,712,15
4020332650,4/16/2016,1,77,77,0,1,1982,1222,21
4020332650,5/3/2016,1,322,332,10,1.031055901,4496,950,0
4020332650,5/4/2016,1,478,536,58,1.121338912,10252,531,46
4020332650,5/5/2016,1,226,248,22,1.097345133,11728,916,42
4020332650,5/6/2016,1,385,408,23,1.05974026,4369,855,0
4020332650,5/8/2016,1,364,402,38,1.104395604,5862,775,0
4020332650,5/10/2016,1,442,494,52,1.117647059,5546,774,0
4319703577,4/14/2016,1,535,557,22,1.041121495,10210,589,9
4319703577,4/15/2016,1,465,491,26,1.055913978,5664,752,0
4319703577,4/16/2016,1,506,522,16,1.031620553,4744,724,0
4319703577,4/18/2016,1,515,551,36,1.069902913,2276,824,9
4319703577,4/19/2016,2,461,498,37,1.080260304,8925,604,0
4319703577,4/20/2016,1,523,543,20,1.038240918,8954,671,18
4319703577,4/21/2016,1,59,65,6,1.101694915,3702,1265,0
4319703577,4/22/2016,1,533,550,17,1.031894934,4500,709,19
4319703577,4/23/2016,1,692,722,30,1.043352601,4935,546,0
4319703577,4/24/2016,1,467,501,34,1.072805139,4081,692,5
4319703577,4/25/2016,1,488,506,18,1.036885246,9259,544,8
4319703577,4/26/2016,1,505,516,11,1.021782178,9899,649,21
4319703577,4/27/2016,1,286,307,21,1.073426573,10780,680,47
4319703577,4/28/2016,1,497,522,25,1.050301811,10817,552,8
4319703577,4/29/2016,1,523,546,23,1.043977055,7990,624,18
4319703577,4/30/2016,1,490,516,26,1.053061224,8221,695,38
4319703577,5/1/2016,1,484,500,16,1.033057851,1251,836,0
4319703577,5/2/2016,1,478,506,28,1.058577406,9261,585,11
4319703577,5/3/2016,1,474,512,38,1.080168776,9648,669,26
4319703577,5/6/2016,1,450,491,41,1.091111111,9524,692,11
4319703577,5/7/2016,1,507,530,23,1.045364892,7937,586,28
4319703577,5/8/2016,1,602,638,36,1.059800664,3672,603,0
4319703577,5/9/2016,1,535,565,30,1.056074766,10378,490,14
4319703577,5/10/2016,1,487,517,30,1.061601643,9487,555,12
4319703577,5/11/2016,1,529,558,29,1.054820416,9129,574,18
4319703577,5/12/2016,1,302,321,19,1.062913907,17,0,0
4388161847,4/15/2016,1,499,526,27,1.054108216,8758,837,0
4388161847,4/16/2016,2,426,448,22,1.051643192,6580,609,9
4388161847,4/17/2016,2,619,641,22,1.035541195,4660,721,0
4388161847,4/18/2016,1,99,104,5,1.050505051,11009,1017,8
4388161847,4/19/2016,1,329,338,9,1.027355623,10181,704,16
4388161847,4/20/2016,1,421,451,30,1.071258907,10553,696,42
4388161847,4/21/2016,1,442,458,16,1.036199095,10055,853,12
4388161847,4/22/2016,1,82,85,3,1.036585366,12139,945,25
4388161847,4/23/2016,1,478,501,23,1.048117155,13236,749,5
4388161847,4/24/2016,3,552,595,43,1.077898551,10243,584,8
4388161847,4/26/2016,1,319,346,27,1.084639498,9461,673,23
4388161847,4/27/2016,1,439,500,61,1.138952164,11193,684,48
4388161847,4/28/2016,1,428,458,30,1.070093458,10074,878,9
4388161847,4/30/2016,2,409,430,21,1.051344743,12533,537,43
4388161847,5/1/2016,1,547,597,50,1.091407678,10255,579,15
4388161847,5/2/2016,2,368,376,8,1.02173913,10096,935,4
4388161847,5/4/2016,1,390,414,24,1.061538462,12375,632,21
4388161847,5/5/2016,1,471,495,24,1.050955414,9603,896,39
4388161847,5/5/2016,1,471,495,24,1.050955414,9603,896,39
4388161847,5/7/2016,1,472,496,24,1.050847458,22770,508,56
4388161847,5/8/2016,2,529,541,12,1.02268431,17298,576,38
4388161847,5/9/2016,1,62,65,3,1.048387097,10218,1020,19
4388161847,5/10/2016,1,354,375,21,1.059322034,10299,648,14
4388161847,5/11/2016,1,469,494,25,1.053304904,10201,858,18
4445114986,4/12/2016,2,429,457,28,1.065268065,3276,787,0
4445114986,4/13/2016,2,370,406,36,1.097297297,2961,840,0
4445114986,4/14/2016,1,441,492,51,1.115646259,3974,717,0
4445114986,4/15/2016,2,337,379,42,1.12462908,7198,711,0
4445114986,4/16/2016,1,462,499,37,1.08008658,3945,716,0
4445114986,4/17/2016,1,98,107,9,1.091836735,2268,1219,0
4445114986,4/19/2016,2,388,424,36,1.092783505,2064,895,0
4445114986,4/20/2016,1,439,462,23,1.0523918,2072,841,0
4445114986,4/21/2016,1,436,469,33,1.075688073,3809,756,0
4445114986,4/22/2016,1,388,417,29,1.074742268,6831,706,0
4445114986,4/25/2016,1,328,345,17,1.051829268,3385,916,0
4445114986,4/26/2016,2,353,391,38,1.107648725,6326,839,1
4445114986,4/27/2016,1,332,374,42,1.126506024,7243,839,1
4445114986,4/28/2016,1,419,442,23,1.054892601,4493,762,0
4445114986,4/29/2016,1,106,108,2,1.018867925,4676,1106,0
4445114986,4/30/2016,1,322,353,31,1.096273292,6222,797,0
4445114986,5/1/2016,2,439,459,20,1.045558087,5232,741,0
4445114986,5/2/2016,1,502,542,40,1.079681275,6910,667,4
4445114986,5/3/2016,2,417,450,33,1.079136691,7502,725,2
4445114986,5/4/2016,2,337,363,26,1.077151335,2923,897,0
4445114986,5/5/2016,2,462,513,51,1.11038961,3800,734,6
4445114986,5/6/2016,2,374,402,28,1.07486631,4514,809,0
4445114986,5/7/2016,2,401,436,35,1.087281796,5183,866,4
4445114986,5/8/2016,1,361,391,30,1.083102493,7303,733,8
4445114986,5/9/2016,1,457,533,76,1.166301969,5275,641,0
4445114986,5/10/2016,1,405,426,21,1.051851852,3915,783,0
4445114986,5/11/2016,1,499,530,31,1.062124248,9105,622,22
4445114986,5/12/2016,1,483,501,18,1.037267081,768,380,0
4558609924,4/21/2016,1,126,137,11,1.087301587,13743,844,21
4558609924,4/26/2016,1,103,121,18,1.174757282,9148,1062,41
4558609924,4/29/2016,1,171,179,8,1.046783626,7833,1096,29
4558609924,5/1/2016,1,115,129,14,1.12173913,3428,1121,0
4558609924,5/8/2016,1,123,134,11,1.089430894,6543,1019,35
4702921684,4/12/2016,1,425,439,14,1.032941176,7213,718,0
4702921684,4/13/2016,2,400,430,30,1.075,6877,777,0
4702921684,4/14/2016,1,384,415,31,1.080729167,7860,772,0
4702921684,4/15/2016,1,253,257,4,1.015810277,6506,944,8
4702921684,4/16/2016,2,382,406,24,1.062827225,11140,556,24
4702921684,4/17/2016,1,591,612,21,1.035532995,12692,437,66
4702921684,4/18/2016,1,293,312,19,1.064846416,9105,890,30
4702921684,4/19/2016,1,457,487,30,1.065645514,6708,757,8
4702921684,4/20/2016,1,454,468,14,1.030837004,8793,717,29
4702921684,4/21/2016,1,425,434,9,1.021176471,6530,901,41
4702921684,4/23/2016,1,465,475,10,1.021505376,15126,469,66
4702921684,4/24/2016,1,480,506,26,1.054166667,15050,542,95
4702921684,4/25/2016,1,370,380,10,1.027027027,9167,730,15
4702921684,4/26/2016,1,421,429,8,1.019002375,6108,765,8
4702921684,4/27/2016,1,432,449,17,1.039351852,7047,733,16
4702921684,4/28/2016,1,442,461,19,1.042986425,9023,738,9
4702921684,4/29/2016,1,433,447,14,1.032332564,9930,692,19
4702921684,4/30/2016,1,479,501,22,1.045929019,10144,728,36
4702921684,5/3/2016,1,327,373,46,1.140672783,9454,729,0
4702921684,5/4/2016,1,412,434,22,1.053398058,8161,757,15
4702921684,5/5/2016,1,414,428,14,1.033816425,8614,745,5
4702921684,5/6/2016,1,404,449,45,1.111386139,6943,682,16
4702921684,5/7/2016,1,520,543,23,1.044230769,14370,577,46
4702921684,5/7/2016,1,520,543,23,1.044230769,14370,577,46
4702921684,5/9/2016,1,435,458,23,1.052873563,8232,746,12
4702921684,5/10/2016,1,416,431,15,1.036057692,10613,701,37
4702921684,5/11/2016,1,354,366,12,1.033898305,9810,784,41
4702921684,5/12/2016,1,404,442,38,1.094059406,2752,241,0
5553957443,4/12/2016,1,441,464,23,1.052154195,11596,767,13
5553957443,4/13/2016,2,455,488,33,1.072527473,4832,647,0
5553957443,4/14/2016,1,357,418,61,1.170868347,17022,693,41
5553957443,4/15/2016,1,377,409,32,1.084880637,16556,689,38
5553957443,4/16/2016,2,651,686,35,1.053763441,5771,521,0
5553957443,4/17/2016,1,350,402,52,1.148571429,655,943,0
5553957443,4/18/2016,2,520,541,21,1.040384615,3727,622,0
5553957443,4/19/2016,1,357,410,53,1.148459384,15482,756,28
5553957443,4/20/2016,1,658,678,20,1.030395137,2713,598,0
5553957443,4/21/2016,1,399,431,32,1.080200501,12346,801,42
5553957443,4/22/2016,1,322,353,31,1.096273292,11682,781,16
5553957443,4/23/2016,2,631,725,94,1.148969889,4112,443,0
5553957443,4/24/2016,2,553,640,87,1.157323689,1807,582,0
5553957443,4/25/2016,1,433,468,35,1.080831409,10946,732,11
5553957443,4/26/2016,1,412,453,41,1.099514563,11886,750,18
5553957443,4/27/2016,1,347,391,44,1.126801153,10538,745,16
5553957443,4/28/2016,1,421,457,36,1.085510689,11393,727,13
5553957443,4/29/2016,1,450,495,45,1.1,12764,709,15
5553957443,4/30/2016,2,775,843,68,1.087741935,1202,506,0
5553957443,5/1/2016,2,622,686,64,1.102893891,5164,436,0
5553957443,5/2/2016,1,409,471,62,1.151589242,9769,724,9
5553957443,5/3/2016,1,380,429,49,1.128947368,12848,812,29
5553957443,5/4/2016,1,447,470,23,1.051454139,4249,651,0
5553957443,5/5/2016,1,419,464,45,1.107398568,14331,692,29
5553957443,5/6/2016,1,400,434,34,1.085,9632,761,9
5553957443,5/7/2016,1,442,470,28,1.063348416,1868,902,0
5553957443,5/8/2016,1,568,608,40,1.070422535,6083,505,8
5553957443,5/9/2016,1,453,494,41,1.090507726,11611,667,22
5553957443,5/10/2016,1,418,443,25,1.059808612,16358,707,40
5553957443,5/11/2016,1,463,486,23,1.049676026,4926,628,0
5553957443,5/12/2016,1,438,475,37,1.084474886,3121,222,6
5577150313,4/12/2016,1,419,438,19,1.045346062,8135,728,16
5577150313,4/13/2016,1,432,458,26,1.060185185,5077,776,11
5577150313,4/14/2016,1,477,497,20,1.041928721,8596,662,30
5577150313,4/15/2016,1,392,413,21,1.053571429,12087,695,54
5577150313,4/16/2016,1,406,445,39,1.096059113,14269,472,56
5577150313,4/17/2016,1,549,583,34,1.061930783,12231,525,37
5577150313,4/18/2016,1,527,553,26,1.049335863,9893,623,32
5577150313,4/19/2016,1,449,465,16,1.035634744,12574,733,23
5577150313,4/20/2016,1,447,480,33,1.073825503,8330,773,16
5577150313,4/21/2016,1,414,437,23,1.055555556,10830,670,74
5577150313,4/22/2016,1,338,366,28,1.082840237,9172,823,30
5577150313,4/23/2016,1,384,402,18,1.046875,7638,627,24
5577150313,4/24/2016,1,543,615,72,1.132596685,15764,425,65
5577150313,4/25/2016,1,421,461,40,1.095011876,6393,743,38
5577150313,4/26/2016,1,354,377,23,1.064971751,5325,759,32
5577150313,4/27/2016,1,424,452,28,1.066037736,6805,773,16
5577150313,4/28/2016,1,361,372,11,1.030470914,9841,692,51
5577150313,4/29/2016,1,459,485,26,1.05664488,7924,739,36
5577150313,4/30/2016,1,412,433,21,1.050970874,12363,621,45
5577150313,5/1/2016,1,379,398,19,1.050131926,13368,499,72
5577150313,5/2/2016,2,525,553,28,1.053333333,7439,732,20
5577150313,5/3/2016,1,508,543,35,1.068897638,11045,580,8
5577150313,5/4/2016,1,603,634,31,1.051409619,5206,631,9
5577150313,5/5/2016,1,74,78,4,1.054054054,7550,1153,21
5577150313,5/10/2016,1,504,562,58,1.115079365,8869,639,37
5577150313,5/11/2016,1,431,476,45,1.104408353,4038,257,15
6117666160,4/16/2016,1,380,398,18,1.047368421,14450,502,15
6117666160,4/17/2016,2,336,350,14,1.041666667,7150,702,0
6117666160,4/18/2016,2,493,510,17,1.034482759,5153,759,0
6117666160,4/19/2016,1,465,492,27,1.058064516,11135,425,0
6117666160,4/20/2016,1,474,502,28,1.05907173,10449,587,10
6117666160,4/21/2016,1,508,550,42,1.082677165,19542,579,19
6117666160,4/22/2016,1,480,546,66,1.1375,8206,413,0
6117666160,4/23/2016,1,492,539,47,1.095528455,11495,468,0
6117666160,4/24/2016,1,353,367,14,1.039660057,7623,711,0
6117666160,4/27/2016,1,542,557,15,1.027675277,9411,417,0
6117666160,4/28/2016,1,393,416,23,1.058524173,3403,758,0
6117666160,4/29/2016,1,600,636,36,1.06,9592,479,0
6117666160,5/1/2016,1,507,575,68,1.134122288,8915,525,0
6117666160,5/5/2016,1,392,415,23,1.058673469,9799,479,0
6117666160,5/6/2016,2,658,698,40,1.060790274,3365,673,0
6117666160,5/7/2016,2,498,507,9,1.018072289,7336,456,0
6117666160,5/8/2016,1,555,603,48,1.086486486,7328,517,0
6117666160,5/9/2016,1,492,522,30,1.06097561,4477,125,0
6775888955,4/13/2016,1,235,260,25,1.106382979,4053,1053,18
6775888955,4/14/2016,1,423,441,18,1.042553191,5162,863,24
6775888955,4/15/2016,1,391,406,15,1.038363171,1282,976,0
6962181067,4/12/2016,1,366,387,21,1.057377049,10199,796,14
6962181067,4/13/2016,3,630,679,49,1.077777778,5652,548,24
6962181067,4/14/2016,2,508,535,27,1.053149606,1551,862,0
6962181067,4/15/2016,1,370,386,16,1.043243243,5563,837,0
6962181067,4/16/2016,1,357,366,9,1.025210084,13217,741,3
6962181067,4/17/2016,1,427,446,19,1.044496487,10145,634,13
6962181067,4/18/2016,1,442,458,16,1.036199095,11404,689,42
6962181067,4/19/2016,1,476,535,59,1.12394958,10742,659,41
6962181067,4/20/2016,1,418,424,6,1.014354067,13928,639,4
6962181067,4/21/2016,1,451,457,6,1.013303769,11835,708,27
6962181067,4/22/2016,1,425,435,10,1.023529412,10725,659,33
6962181067,4/23/2016,1,528,546,18,1.034090909,20031,484,41
6962181067,4/24/2016,1,511,514,3,1.005870841,5029,720,0
6962181067,4/25/2016,1,400,415,15,1.0375,13239,637,31
6962181067,4/26/2016,1,441,446,5,1.011337868,10433,680,7
6962181067,4/27/2016,1,455,467,12,1.026373626,10320,697,38
6962181067,4/28/2016,1,440,453,13,1.029545455,12627,621,8
6962181067,4/29/2016,1,433,447,14,1.032332564,10762,645,15
6962181067,4/30/2016,1,422,424,2,1.004739336,10081,731,16
6962181067,5/1/2016,1,411,426,15,1.03649635,5454,722,0
6962181067,5/2/2016,1,466,482,16,1.034334764,12912,655,39
6962181067,5/3/2016,1,394,418,24,1.060913706,12109,654,36
6962181067,5/4/2016,1,442,455,13,1.029411765,10147,683,36
6962181067,5/5/2016,1,467,491,24,1.051391863,10524,591,22
6962181067,5/6/2016,1,443,462,19,1.042889391,5908,717,0
6962181067,5/7/2016,1,298,334,36,1.120805369,6815,745,0
6962181067,5/8/2016,1,541,569,28,1.051756007,4188,709,14
6962181067,5/9/2016,1,489,497,8,1.016359918,12342,607,21
6962181067,5/10/2016,1,469,481,12,1.025586354,15448,626,34
6962181067,5/11/2016,1,452,480,28,1.061946903,6722,709,7
6962181067,5/12/2016,1,516,535,19,1.036821705,3587,127,8
7007744171,4/16/2016,1,79,82,3,1.037974684,4631,1155,0
7007744171,5/1/2016,1,58,61,3,1.051724138,5600,1142,0
7086361926,4/12/2016,1,514,525,11,1.021400778,11317,745,6
7086361926,4/13/2016,1,451,465,14,1.031042129,5813,744,26
7086361926,4/14/2016,1,472,476,4,1.008474576,9123,787,32
7086361926,4/15/2016,1,377,386,9,1.023872679,8585,864,21
7086361926,4/19/2016,1,472,483,11,1.023305085,10688,671,69
7086361926,4/20/2016,1,492,502,10,1.020325203,14365,797,13
7086361926,4/21/2016,1,390,411,21,1.053846154,9469,758,6
7086361926,4/22/2016,1,428,448,20,1.046728972,9753,762,59
7086361926,4/24/2016,1,681,704,23,1.033773862,3520,566,0
7086361926,4/25/2016,1,446,447,1,1.002242152,10091,706,39
7086361926,4/26/2016,1,485,500,15,1.030927835,10387,726,33
7086361926,4/27/2016,1,469,479,10,1.021321962,11107,829,6
7086361926,4/28/2016,1,354,367,13,1.036723164,11584,810,48
7086361926,4/30/2016,1,485,489,4,1.008247423,14560,584,17
7086361926,5/1/2016,1,388,407,19,1.048969072,12390,685,15
7086361926,5/2/2016,1,440,459,19,1.043181818,10052,737,26
7086361926,5/3/2016,1,456,461,5,1.010964912,10288,761,36
7086361926,5/4/2016,1,420,436,16,1.038095238,10988,843,12
7086361926,5/6/2016,1,322,333,11,1.034161491,12461,834,35
7086361926,5/7/2016,1,530,548,18,1.033962264,12827,621,42
7086361926,5/8/2016,1,481,510,29,1.06029106,10677,695,27
7086361926,5/9/2016,1,427,438,11,1.025761124,13566,743,50
7086361926,5/11/2016,1,451,463,12,1.026607539,9572,757,40
7086361926,5/12/2016,1,444,457,13,1.029279279,3789,343,4
8053475328,4/20/2016,1,486,493,7,1.014403292,15108,695,5
8053475328,4/23/2016,1,331,337,6,1.018126888,22359,741,14
8053475328,5/7/2016,1,74,75,1,1.013513514,19769,1076,20
8378563200,4/12/2016,1,338,356,18,1.053254438,7626,723,15
8378563200,4/13/2016,2,447,487,40,1.089485459,12386,680,14
8378563200,4/14/2016,1,424,455,31,1.073113208,13318,699,21
8378563200,4/15/2016,1,513,533,20,1.038986355,14461,729,23
8378563200,4/16/2016,2,611,689,78,1.127659574,11207,563,21
8378563200,4/17/2016,2,525,591,66,1.125714286,2132,599,0
8378563200,4/18/2016,1,398,451,53,1.133165829,13630,720,10
8378563200,4/19/2016,1,387,421,34,1.087855297,13070,737,19
8378563200,4/20/2016,1,381,409,28,1.073490814,9388,763,8
8378563200,4/21/2016,1,396,417,21,1.053030303,15148,677,16
8378563200,4/22/2016,1,441,469,28,1.063492063,12200,769,12
8378563200,4/23/2016,1,565,591,26,1.046017699,5709,740,10
8378563200,4/24/2016,1,458,492,34,1.074235808,3703,734,0
8378563200,4/25/2016,1,388,402,14,1.036082474,12405,692,16
8378563200,4/25/2016,1,388,402,14,1.036082474,12405,692,16
8378563200,4/26/2016,1,550,584,34,1.061818182,16208,593,18
8378563200,4/27/2016,1,531,600,69,1.129943503,7359,676,4
8378563200,4/28/2016,1,506,556,50,1.098814229,5417,711,10
8378563200,4/29/2016,1,527,562,35,1.066413662,6175,767,7
8378563200,4/30/2016,1,468,555,87,1.185897436,2946,780,0
8378563200,5/1/2016,1,475,539,64,1.134736842,11419,669,10
8378563200,5/2/2016,1,351,385,34,1.096866097,6064,802,4
8378563200,5/3/2016,1,405,429,24,1.059259259,8712,822,20
8378563200,5/4/2016,1,441,477,36,1.081632653,7875,680,10
8378563200,5/5/2016,1,381,417,36,1.094488189,8567,764,3
8378563200,5/6/2016,1,323,355,32,1.099071207,7045,831,5
8378563200,5/7/2016,2,459,513,54,1.117647059,4468,851,0
8378563200,5/8/2016,1,545,606,61,1.111926606,2943,621,0
8378563200,5/9/2016,1,359,399,40,1.111420613,8382,772,13
8378563200,5/10/2016,1,342,391,49,1.143274854,6582,840,13
8378563200,5/11/2016,1,368,387,19,1.051630435,9143,763,10
8378563200,5/12/2016,1,496,546,50,1.100806452,4561,433,6
8792009665,4/12/2016,1,458,493,35,1.076419214,2564,831,0
8792009665,4/13/2016,1,531,552,21,1.039548023,1320,806,0
8792009665,4/14/2016,1,486,503,17,1.034979424,1219,853,0
8792009665,4/15/2016,1,363,377,14,1.038567493,2483,937,0
8792009665,4/20/2016,1,528,547,19,1.035984848,3147,744,10
8792009665,4/22/2016,1,391,407,16,1.040920716,4068,817,20
8792009665,4/23/2016,1,339,360,21,1.061946903,5245,795,45
8792009665,4/27/2016,1,423,428,5,1.011820331,1758,900,0
8792009665,4/28/2016,1,402,416,14,1.034825871,6157,714,0
8792009665,4/29/2016,1,398,406,8,1.020100503,8360,634,14
8792009665,4/30/2016,1,343,360,17,1.049562682,7174,749,20
8792009665,5/1/2016,1,503,527,24,1.047713718,1619,834,0
8792009665,5/2/2016,1,415,423,8,1.019277108,1831,916,0
8792009665,5/3/2016,1,516,545,29,1.05620155,2421,739,0
8792009665,5/4/2016,1,439,463,24,1.054669704,2283,848,0
8792009665,6/4/2016,1,517,542,25,1.048355899,3771,2,14
8792009665,7/4/2016,1,419,440,21,1.050119332,2081,170,12
8792009665,8/4/2016,1,448,477,29,1.064732143,2448,4,7
8792009665,9/4/2016,1,450,472,22,1.048888889,3552,199,10
8792009665,10/4/2016,1,450,477,27,1.06,3113,198,32
8792009665,11/4/2016,1,594,616,22,1.037037037,2054,27,40
8792009665,12/4/2016,1,411,421,10,1.0243309,2598,230,9
8792009665,13/4/2016,1,544,573,29,1.053308824,4930,90,44
8792009665,14/4/2016,1,476,506,30,1.06302521,2280,56,44
8792009665,15/4/2016,1,421,450,29,1.06888361,3083,98,16
8792009665,16/4/2016,1,492,518,26,1.052845528,3003,48,42
8792009665,17/4/2016,1,414,429,15,1.036231884,3638,85,5
8792009665,18/4/2016,1,533,558,25,1.046904315,2120,38,16
8792009665,19/4/2016,1,555,561,6,1.010810811,2732,188,26
8792009665,20/4/2016,1,436,443,7,1.016055046,4898,214,30
8792009665,21/4/2016,1,576,583,7,1.012152778,4042,157,3
8792009665,22/4/2016,1,479,490,11,1.022964509,1613,177,43
8792009665,23/4/2016,1,451,471,20,1.044345898,1796,54,39
8792009665,24/4/2016,1,570,584,14,1.024561404,1981,123,15
8792009665,25/4/2016,1,533,556,23,1.04315197,4995,75,41
8792009665,26/4/2016,1,584,594,10,1.017123288,3447,171,37
8792009665,27/4/2016,1,578,589,11,1.019031142,2467,20,6
8792009665,28/4/2016,1,446,475,29,1.065022422,3204,106,28
8792009665,29/4/2016,1,432,442,10,1.023148148,2039,75,41
8792009665,30/4/2016,1,456,461,5,1.010964912,3777,58,45
8792009665,1/5/2016,1,444,473,29,1.065315315,2790,60,1
8792009665,2/5/2016,1,519,532,13,1.02504817,2509,213,35
8792009665,3/5/2016,1,553,581,28,1.050632911,3950,174,9
8792009665,4/5/2016,1,540,568,28,1.051851852,4078,13,44
8792009665,5/5/2016,1,575,589,14,1.024347826,4979,86,25
8792009665,6/5/2016,1,489,512,23,1.047034765,4015,133,15
8792009665,7/5/2016,1,530,549,19,1.035849057,2563,134,25
8792009665,8/5/2016,1,542,564,22,1.040590406,1872,40,30
8792009665,9/5/2016,1,548,574,26,1.047445255,3994,162,33
8792009665,10/5/2016,1,432,442,10,1.023148148,4494,180,22
8792009665,11/5/2016,1,458,476,18,1.03930131,3294,175,6
8792009665,12/5/2016,1,583,603,20,1.034305317,2455,235,13
8792009665,13/5/2016,1,458,472,14,1.030567686,3819,13,15
8792009665,14/5/2016,1,567,574,7,1.012345679,3070,115,24
8792009665,15/5/2016,1,563,571,8,1.014209591,4752,7,18
8792009665,16/5/2016,1,498,520,22,1.044176707,2352,233,40
8792009665,17/5/2016,1,458,474,16,1.034934498,3658,73,45
8792009665,18/5/2016,1,572,592,20,1.034965035,3186,130,5
8792009665,19/5/2016,1,533,542,9,1.016885553,3810,144,21
8792009665,20/5/2016,1,563,575,12,1.021314387,1764,208,31
8792009665,21/5/2016,1,547,561,14,1.02559415,3813,88,41
8792009665,22/5/2016,1,573,588,15,1.02617801,3623,122,35
8792009665,23/5/2016,1,477,501,24,1.050314465,4452,116,7
8792009665,24/5/2016,1,556,583,27,1.048561151,1626,140,30
8792009665,25/5/2016,1,460,485,25,1.054347826,2222,79,32
8792009665,26/5/2016,1,541,555,14,1.025878004,3754,232,21
8792009665,27/5/2016,1,532,550,18,1.033834586,2622,216,44
8792009665,28/5/2016,1,538,546,8,1.014869888,2123,238,42
8792009665,29/5/2016,1,483,499,16,1.033126294,2669,5,20
8792009665,30/5/2016,1,478,493,15,1.031380753,3141,90,1
8792009665,31/5/2016,1,558,574,16,1.028673835,1768,171,5
8792009665,1/6/2016,1,583,596,13,1.022298456,2099,29,18
8792009665,2/6/2016,1,408,414,6,1.014705882,3349,231,41
8792009665,3/6/2016,1,418,442,24,1.057416268,4180,100,6
8792009665,4/6/2016,1,571,581,10,1.017513135,4617,238,41
8792009665,5/6/2016,1,549,568,19,1.034608379,4229,12,12
8792009665,6/6/2016,1,574,583,9,1.015679443,3981,192,2
8792009665,7/6/2016,1,496,511,15,1.030241935,2699,192,7
8792009665,8/6/2016,1,417,433,16,1.038369305,4142,11,6
8792009665,9/6/2016,1,498,517,19,1.03815261,3148,115,8
8792009665,10/6/2016,1,598,611,13,1.02173913,1798,225,13
8792009665,11/6/2016,1,403,409,6,1.014888337,4681,9,6
8792009665,12/6/2016,1,553,566,13,1.023508137,1556,93,12
8792009665,13/6/2016,1,577,588,11,1.019064125,2372,171,14
8792009665,14/6/2016,1,471,476,5,1.010615711,4224,240,2
8792009665,15/6/2016,1,407,412,5,1.012285012,3208,196,10
8792009665,16/6/2016,1,576,591,15,1.026041667,4495,229,40
8792009665,17/6/2016,1,540,562,22,1.040740741,4883,114,32
8792009665,18/6/2016,1,462,481,19,1.041125541,2653,227,19
8792009665,19/6/2016,1,568,594,26,1.045774648,4746,74,25
8792009665,20/6/2016,1,407,415,8,1.01965602,3890,156,11
8792009665,21/6/2016,1,522,545,23,1.044061303,1622,211,16
8792009665,22/6/2016,1,413,439,26,1.062953995,2194,239,28
8792009665,23/6/2016,1,456,483,27,1.059210526,2485,203,18
8792009665,24/6/2016,1,508,519,11,1.021653543,2416,176,1
8792009665,25/6/2016,1,408,436,28,1.068627451,3913,136,33
8792009665,26/6/2016,1,564,588,24,1.042553191,1816,115,28
8792009665,27/6/2016,1,571,598,27,1.047285464,2219,43,6
8792009665,28/6/2016,1,496,505,9,1.018145161,4615,194,4
8792009665,29/6/2016,1,437,458,21,1.04805492,3847,229,8
8792009665,30/6/2016,1,451,457,6,1.013303769,3251,119,13
8792009665,1/7/2016,1,506,526,20,1.039525692,4563,176,36
8792009665,2/7/2016,1,536,551,15,1.027985075,4158,55,18
8792009665,3/7/2016,1,578,605,27,1.046712803,3259,109,16
8792009665,4/7/2016,1,488,515,27,1.055327869,2048,174,21
8792009665,5/7/2016,1,438,452,14,1.03196347,2770,21,0
8792009665,6/7/2016,1,540,556,16,1.02962963,3967,127,4
8792009665,7/7/2016,1,556,570,14,1.025179856,2609,83,19
8792009665,8/7/2016,1,570,577,7,1.012280702,2066,70,10
8792009665,9/7/2016,1,581,594,13,1.022375215,4493,35,10
8792009665,10/7/2016,1,560,586,26,1.046428571,4656,17,29
8792009665,11/7/2016,1,519,541,22,1.04238921,3353,235,30
8792009665,12/7/2016,1,416,432,16,1.038461538,3200,90,20
8792009665,13/7/2016,1,556,565,9,1.01618705,3446,101,2
8792009665,14/7/2016,1,520,531,11,1.021153846,4037,127,30
8792009665,15/7/2016,1,455,481,26,1.057142857,3379,237,18
8792009665,16/7/2016,1,434,447,13,1.029953917,1978,112,35
8792009665,17/7/2016,1,557,562,5,1.008976661,3792,13,45
8792009665,18/7/2016,1,497,512,15,1.030181087,4625,221,17
8792009665,19/7/2016,1,423,444,21,1.04964539,1514,35,44
8792009665,20/7/2016,1,508,523,15,1.029527559,4183,142,9
8792009665,21/7/2016,1,469,482,13,1.02771855,2382,61,39
8792009665,22/7/2016,1,429,442,13,1.03030303,2325,214,26
8792009665,23/7/2016,1,594,606,12,1.02020202,2328,146,41
8792009665,24/7/2016,1,573,586,13,1.022687609,3917,106,3
8792009665,25/7/2016,1,444,457,13,1.029279279,4036,49,2
8792009665,26/7/2016,1,525,540,15,1.028571429,4663,152,22
8792009665,27/7/2016,1,451,480,29,1.064301552,3618,58,13
8792009665,28/7/2016,1,531,550,19,1.035781544,2554,118,9
8792009665,29/7/2016,1,561,575,14,1.024955437,3630,91,45
8792009665,30/7/2016,1,598,627,29,1.048494983,3600,83,43
8792009665,31/7/2016,1,453,465,12,1.026490066,4898,240,12
8792009665,1/8/2016,1,422,441,19,1.045023697,3734,73,36
8792009665,2/8/2016,1,520,533,13,1.025,3990,203,14
8792009665,3/8/2016,1,489,502,13,1.026584867,3175,103,26
8792009665,4/8/2016,1,413,420,7,1.016949153,3572,72,25
8792009665,5/8/2016,1,406,417,11,1.027093596,3031,194,5
8792009665,6/8/2016,1,478,492,14,1.029288703,4410,7,0
8792009665,7/8/2016,1,587,594,7,1.011925043,3811,155,11
8792009665,8/8/2016,1,434,440,6,1.013824885,1675,139,39
8792009665,9/8/2016,1,547,561,14,1.02559415,2673,65,34
8792009665,10/8/2016,1,451,481,30,1.066518847,2048,13,34
8792009665,11/8/2016,1,490,496,6,1.012244898,4813,89,33
8792009665,12/8/2016,1,406,424,18,1.044334975,2576,105,22
8792009665,13/8/2016,1,581,586,5,1.008605852,1555,150,4
8792009665,14/8/2016,1,492,517,25,1.050813008,2016,188,31
8792009665,15/8/2016,1,474,494,20,1.042194093,5974,142,39
8792009665,16/8/2016,1,438,459,21,1.047945205,5726,478,55
8792009665,17/8/2016,1,563,613,50,1.088809947,5073,318,57
8792009665,18/8/2016,1,581,631,50,1.08605852,7304,348,55
8792009665,19/8/2016,1,491,526,35,1.071283096,9955,459,54
8792009665,20/8/2016,1,404,445,41,1.101485149,9327,447,54
8792009665,21/8/2016,1,406,442,36,1.088669951,7803,351,53
8792009665,22/8/2016,1,561,612,51,1.090909091,6324,368,47
8792009665,23/8/2016,1,423,466,43,1.101654846,8548,334,54
8792009665,24/8/2016,1,567,602,35,1.061728395,6625,263,54
8792009665,25/8/2016,1,570,617,47,1.08245614,6620,267,53
8792009665,26/8/2016,1,589,634,45,1.076400679,5607,499,47
8792009665,27/8/2016,1,471,506,35,1.074309979,8976,435,56
8792009665,28/8/2016,1,432,484,52,1.12037037,5447,267,49
8792009665,29/8/2016,1,536,590,54,1.100746269,5916,438,49
8792009665,30/8/2016,1,570,602,32,1.056140351,7257,326,46
8792009665,31/8/2016,1,451,494,43,1.095343681,5492,285,48
8792009665,1/9/2016,1,403,439,36,1.089330025,8612,245,49
8792009665,2/9/2016,1,533,577,44,1.082551595,5756,279,59
8792009665,3/9/2016,1,427,486,59,1.138173302,7495,440,47
8792009665,4/9/2016,1,464,508,44,1.094827586,7093,414,51
8792009665,5/9/2016,1,421,457,36,1.085510689,5086,265,52
8792009665,6/9/2016,1,410,448,38,1.092682927,7117,302,49
8792009665,7/9/2016,1,435,468,33,1.075862069,8064,298,45
8792009665,8/9/2016,1,595,628,33,1.055462185,9818,360,51
8792009665,9/9/2016,1,569,620,51,1.089630931,6351,276,45
8792009665,10/9/2016,1,510,544,34,1.066666667,5489,348,46
8792009665,11/9/2016,1,443,503,60,1.135440181,8065,490,55
8792009665,12/9/2016,1,505,559,54,1.106930693,6580,292,59
8792009665,13/9/2016,1,474,506,32,1.067510549,7696,329,52
8792009665,14/9/2016,1,563,610,47,1.08348135,7493,445,48
8792009665,15/9/2016,1,433,479,46,1.106235566,9978,315,51
8792009665,16/9/2016,1,497,529,32,1.064386318,8118,256,45
8792009665,17/9/2016,1,545,592,47,1.086238532,5983,500,60
8792009665,18/9/2016,1,465,523,58,1.124731183,5934,476,56
8792009665,19/9/2016,1,448,490,42,1.09375,8610,243,56
8792009665,20/9/2016,1,531,570,39,1.073446328,5795,278,56
8792009665,21/9/2016,1,536,577,41,1.076492537,9933,280,46
8792009665,22/9/2016,1,495,541,46,1.092929293,8427,318,46
8792009665,23/9/2016,1,537,587,50,1.09310987,6983,246,47
8792009665,24/9/2016,1,503,539,36,1.071570577,5507,274,53
8792009665,25/9/2016,1,555,601,46,1.082882883,6113,443,55
8792009665,26/9/2016,1,467,512,45,1.096359743,8302,311,58
8792009665,27/9/2016,1,400,431,31,1.0775,8468,255,50
8792009665,28/9/2016,1,545,585,40,1.073394495,6858,344,48
8792009665,29/9/2016,1,506,548,42,1.083003953,8676,414,47
8792009665,30/9/2016,1,554,587,33,1.059566787,9032,256,57
8792009665,1/10/2016,1,441,494,53,1.120181406,5029,346,54
8792009665,2/10/2016,1,584,643,59,1.101027397,8114,432,59
8792009665,3/10/2016,1,576,630,54,1.09375,8261,436,47
8792009665,4/10/2016,1,517,555,38,1.073500967,9806,500,51
8792009665,5/10/2016,1,539,592,53,1.098330241,7083,282,60
8792009665,6/10/2016,1,409,455,46,1.112469438,5189,394,56
8792009665,7/10/2016,1,478,535,57,1.119246862,5717,319,54
8792009665,8/10/2016,1,482,529,47,1.097510373,5216,414,53
8792009665,9/10/2016,1,546,594,48,1.087912088,6317,275,51
8792009665,10/10/2016,1,489,522,33,1.067484663,7049,346,55
8792009665,11/10/2016,1,592,646,54,1.091216216,8984,259,54
8792009665,12/10/2016,1,491,539,48,1.097759674,6228,244,50
8792009665,13/10/2016,1,504,546,42,1.083333333,8795,433,49
8792009665,14/10/2016,1,457,506,49,1.107221007,5466,464,48
8792009665,15/10/2016,1,448,491,43,1.095982143,6939,261,58
8792009665,16/10/2016,1,553,609,56,1.101265823,7750,327,45
8792009665,17/10/2016,1,466,506,40,1.08583691,6791,399,49
8792009665,18/10/2016,1,545,591,46,1.08440367,9052,250,53
8792009665,19/10/2016,1,454,486,32,1.070484581,7138,400,59
8792009665,20/10/2016,1,566,607,41,1.072438163,5140,424,56
8792009665,21/10/2016,1,441,484,43,1.097505669,9134,458,56
8792009665,22/10/2016,1,598,651,53,1.088628763,9800,334,49
8792009665,23/10/2016,1,479,512,33,1.068893528,5066,404,48
8792009665,24/10/2016,1,464,514,50,1.107758621,7947,422,48
8792009665,25/10/2016,1,470,520,50,1.106382979,6236,374,49
8792009665,26/10/2016,1,588,646,58,1.098639456,5208,486,55
8792009665,27/10/2016,1,562,592,30,1.053380783,5964,403,50
8792009665,28/10/2016,1,488,539,51,1.104508197,9009,413,57
8792009665,29/10/2016,1,482,539,57,1.118257261,7637,294,47
8792009665,30/10/2016,1,414,471,57,1.137681159,5169,326,52
8792009665,31/10/2016,1,561,601,40,1.071301248,6336,454,45
8792009665,1/11/2016,1,407,455,48,1.117936118,5815,398,46
8792009665,2/11/2016,1,483,539,56,1.115942029,6630,490,51
8792009665,3/11/2016,1,564,604,40,1.070921986,5436,497,46
8792009665,4/11/2016,1,416,467,51,1.122596154,5970,342,57
8792009665,5/11/2016,1,559,603,44,1.078711986,8674,411,49
8792009665,6/11/2016,1,497,531,34,1.068410463,8454,348,52
8792009665,7/11/2016,1,406,447,41,1.100985222,8442,457,48
8792009665,8/11/2016,1,446,495,49,1.109865471,7654,318,49
8792009665,9/11/2016,1,594,653,59,1.099326599,6804,370,53
8792009665,10/11/2016,1,571,604,33,1.057793345,5635,406,46
8792009665,11/11/2016,1,572,612,40,1.06993007,7661,241,54
8792009665,12/11/2016,1,585,634,49,1.083760684,5826,312,59
8792009665,13/11/2016,1,421,480,59,1.140142518,8954,407,59
8792009665,14/11/2016,1,451,511,60,1.133037694,6260,338,53
8792009665,15/11/2016,1,597,628,31,1.051926298,8492,374,54
8792009665,16/11/2016,1,422,464,42,1.099526066,7071,348,47
8792009665,17/11/2016,1,529,575,46,1.086956522,9504,319,47
8792009665,18/11/2016,1,451,505,54,1.119733925,8379,349,60
8792009665,19/11/2016,1,590,644,54,1.091525424,6847,251,51
8792009665,20/11/2016,1,411,471,60,1.145985401,9700,436,55
8792009665,21/11/2016,1,585,618,33,1.056410256,9336,459,53
8792009665,22/11/2016,1,516,570,54,1.104651163,6257,247,45
8792009665,23/11/2016,1,543,590,47,1.086556169,6259,496,55
8792009665,24/11/2016,1,571,605,34,1.059544658,6671,332,54
8792009665,25/11/2016,1,443,492,49,1.110609481,7899,244,47
8792009665,26/11/2016,1,426,475,49,1.115023474,6922,327,51
8792009665,27/11/2016,1,561,605,44,1.078431373,5330,265,53
8792009665,28/11/2016,1,504,536,32,1.063492063,5764,325,54
8792009665,29/11/2016,1,497,540,43,1.086519115,9026,287,52
8792009665,30/11/2016,1,588,645,57,1.096938776,8268,260,51
8792009665,1/12/2016,1,484,520,36,1.074380165,9769,402,55
8792009665,2/12/2016,1,593,648,55,1.092748735,8189,337,59
8792009665,3/12/2016,1,462,512,50,1.108225108,8071,335,45
8792009665,4/12/2016,1,595,653,58,1.097478992,8048,473,52
8792009665,5/12/2016,1,572,629,57,1.09965035,7105,318,51
8792009665,6/12/2016,1,456,511,55,1.120614035,6837,361,57
8792009665,7/12/2016,1,596,655,59,1.098993289,6813,396,59
8792009665,8/12/2016,1,470,518,48,1.10212766,6196,247,60
8792009665,9/12/2016,1,550,582,32,1.058181818,7415,243,46
8792009665,10/12/2016,1,462,492,30,1.064935065,7956,373,53
8792009665,11/12/2016,1,416,455,39,1.09375,5424,301,56
8792009665,12/12/2016,1,445,482,37,1.083146067,6284,283,55
8792009665,13/12/2016,1,510,562,52,1.101960784,5004,462,50
8792009665,14/12/2016,1,519,554,35,1.06743738,5331,475,52
8792009665,15/12/2016,1,438,468,30,1.068493151,7508,250,51
8792009665,16/12/2016,1,462,494,32,1.069264069,5389,472,53
8792009665,17/12/2016,1,463,503,40,1.086393089,9091,294,48
8792009665,18/12/2016,1,453,499,46,1.101545254,8987,283,45
8792009665,19/12/2016,1,579,612,33,1.056994819,9830,427,51
8792009665,20/12/2016,1,573,619,46,1.080279232,5280,259,58
8792009665,21/12/2016,1,424,474,50,1.117924528,5954,269,52
8792009665,22/12/2016,1,582,641,59,1.10137457,6003,498,45
8792009665,23/12/2016,1,461,500,39,1.084598698,7940,529,50
8792009665,24/12/2016,1,508,554,46,1.090551181,6638,568,84
8792009665,25/12/2016,1,588,621,33,1.056122449,5912,611,65
8792009665,26/12/2016,1,528,582,54,1.102272727,9310,581,92
8792009665,27/12/2016,1,534,565,31,1.058052434,14558,506,93
8792009665,28/12/2016,1,527,559,32,1.060721063,13908,667,74
8792009665,29/12/2016,1,479,557,78,1.162839248,11421,613,70
8792009665,30/12/2016,1,481,544,63,1.130977131,12385,682,90
8792009665,31/12/2016,1,548,621,73,1.133211679,13486,689,91
8792009665,1/1/2017,1,554,632,78,1.140794224,13753,530,96
8792009665,2/1/2017,1,416,478,62,1.149038462,11287,671,95
8792009665,3/1/2017,1,532,597,65,1.122180451,13703,679,76
8792009665,4/1/2017,1,571,637,66,1.11558669,15856,621,62
8792009665,5/1/2017,1,445,508,63,1.141573034,18082,605,94
8792009665,6/1/2017,1,422,499,77,1.182464455,11536,638,75
8792009665,7/1/2017,1,496,582,86,1.173387097,19013,684,70
8792009665,8/1/2017,1,465,546,81,1.174193548,16853,513,95
8792009665,9/1/2017,1,580,643,63,1.10862069,15616,545,90
8792009665,10/1/2017,1,475,538,63,1.132631579,14148,690,69
8792009665,11/1/2017,1,469,545,76,1.162046908,14960,663,100
8792009665,12/1/2017,1,478,562,84,1.175732218,13265,523,66
8792009665,13/1/2017,1,561,621,60,1.106951872,15896,525,94
8792009665,14/1/2017,1,569,659,90,1.158172232,12736,682,81
8792009665,15/1/2017,1,548,635,87,1.158759124,10336,510,100
8792009665,16/1/2017,1,457,540,83,1.181619256,16937,556,97
8792009665,17/1/2017,1,425,502,77,1.181176471,10029,614,62
8792009665,18/1/2017,1,431,521,90,1.208816705,15878,531,64
8792009665,19/1/2017,1,412,481,69,1.167475728,18039,536,89
8792009665,20/1/2017,1,469,535,66,1.140724947,16683,557,69
8792009665,21/1/2017,1,542,602,60,1.110701107,10094,622,87
8792009665,22/1/2017,1,508,581,73,1.143700787,11534,520,80
8792009665,23/1/2017,1,456,540,84,1.184210526,12952,649,67
8792009665,24/1/2017,1,535,598,63,1.117757009,14827,570,77
8792009665,25/1/2017,1,595,664,69,1.115966387,12582,688,87
8792009665,26/1/2017,1,478,551,73,1.152719665,14314,510,92
8792009665,27/1/2017,1,420,507,87,1.207142857,10656,573,80
8792009665,28/1/2017,1,595,669,74,1.124369748,13928,630,77
8792009665,29/1/2017,1,471,542,71,1.1507431,11622,677,64
8792009665,30/1/2017,1,438,498,60,1.136986301,14418,579,85
8792009665,31/1/2017,1,489,557,68,1.139059305,16166,601,91
8792009665,1/2/2017,1,468,543,75,1.16025641,16448,613,74
8792009665,2/2/2017,1,469,543,74,1.157782516,18485,518,62
8792009665,3/2/2017,1,495,566,71,1.143434343,16891,604,98
8792009665,4/2/2017,1,518,585,67,1.129343629,11540,660,75
8792009665,5/2/2017,1,467,554,87,1.186295503,15141,637,91
8792009665,6/2/2017,1,505,572,67,1.132673267,14870,632,81
8792009665,7/2/2017,1,441,518,77,1.174603175,12529,549,79
8792009665,8/2/2017,1,436,520,84,1.19266055,16109,600,94
8792009665,9/2/2017,1,513,587,74,1.144249513,14723,580,98
8792009665,10/2/2017,1,588,677,89,1.151360544,18805,668,67
8792009665,11/2/2017,1,543,603,60,1.110497238,17237,531,79
8792009665,12/2/2017,1,411,480,69,1.167883212,13329,536,79
8792009665,13/2/2017,1,571,639,68,1.119089317,16087,694,64
8792009665,14/2/2017,1,512,581,69,1.134765625,13670,609,97
8792009665,15/2/2017,1,498,570,72,1.144578313,14935,694,91
8792009665,16/2/2017,1,554,614,60,1.108303249,13829,631,84
8792009665,17/2/2017,1,578,649,71,1.12283737,12691,530,91
8792009665,18/2/2017,1,533,623,90,1.168855535,12791,570,78
8792009665,19/2/2017,1,499,566,67,1.134268537,10216,560,97
8792009665,20/2/2017,1,486,567,81,1.166666667,15074,606,100
8792009665,21/2/2017,1,465,553,88,1.189247312,15082,561,98
8792009665,22/2/2017,1,452,529,77,1.170353982,14337,691,64
8792009665,23/2/2017,1,463,533,70,1.151187905,10855,551,78
8792009665,24/2/2017,1,514,586,72,1.140077821,14258,647,70
8792009665,25/2/2017,1,568,645,77,1.13556338,13545,611,73
8792009665,26/2/2017,1,406,471,65,1.160098522,13837,573,90
8792009665,27/2/2017,1,493,582,89,1.180527383,17039,589,87
8792009665,28/2/2017,1,474,557,83,1.175105485,12533,511,62
8792009665,1/3/2017,1,467,554,87,1.186295503,10762,683,90
8792009665,2/3/2017,1,496,566,70,1.141129032,14551,631,61
8792009665,3/3/2017,1,480,553,73,1.152083333,13674,568,90
8792009665,4/3/2017,1,594,682,88,1.148148148,15486,584,69
8792009665,5/3/2017,1,498,579,81,1.162650602,16075,637,92
8792009665,6/3/2017,1,496,559,63,1.127016129,19102,562,97
8792009665,7/3/2017,1,443,517,74,1.167042889,14530,641,82
8792009665,8/3/2017,1,421,507,86,1.204275534,16898,637,65
8792009665,9/3/2017,1,418,501,83,1.198564593,10438,528,74
8792009665,10/3/2017,1,517,599,82,1.15860735,19359,692,65
8792009665,11/3/2017,1,588,676,88,1.149659864,12114,668,97
8792009665,12/3/2017,1,557,645,88,1.157989228,10241,570,62
8792009665,13/3/2017,1,438,503,65,1.148401826,16485,626,68
8792009665,14/3/2017,1,428,502,74,1.172897196,15341,589,88
8792009665,15/3/2017,1,463,523,60,1.129589633,15158,608,78
8792009665,16/3/2017,1,466,542,76,1.163090129,15134,610,84
8792009665,17/3/2017,1,412,496,84,1.203883495,11251,569,85
8792009665,18/3/2017,1,484,563,79,1.16322314,18097,697,98
8792009665,19/3/2017,1,474,548,74,1.156118143,16399,592,71
8792009665,20/3/2017,1,542,630,88,1.162361624,14002,640,62
8792009665,21/3/2017,1,556,627,71,1.127697842,10065,664,95
8792009665,22/3/2017,1,534,597,63,1.117977528,15985,611,64
8792009665,23/3/2017,1,534,622,88,1.164794007,16926,516,75
8792009665,24/3/2017,1,528,617,89,1.168560606,17591,692,80
8792009665,25/3/2017,1,405,484,79,1.195061728,18853,674,64
8792009665,26/3/2017,1,485,564,79,1.162886598,18507,579,90
8792009665,27/3/2017,1,427,501,74,1.173302108,19779,511,76
8792009665,28/3/2017,1,521,602,81,1.15547025,16643,650,72
8792009665,29/3/2017,1,423,511,88,1.208037825,18695,686,63
8792009665,30/3/2017,1,583,662,79,1.135506003,17001,662,89
8792009665,31/3/2017,1,497,563,66,1.132796781,14738,618,85
8792009665,1/4/2017,1,540,620,80,1.148148148,11043,617,70
8792009665,2/4/2017,1,468,542,74,1.158119658,10850,545,80
8792009665,3/4/2017,1,597,661,64,1.10720268,16848,626,75
8792009665,4/4/2017,1,557,621,64,1.114901257,18249,648,85
8792009665,5/4/2017,1,550,615,65,1.118181818,17046,583,61
8792009665,6/4/2017,1,585,662,77,1.131623932,12656,643,98
8792009665,7/4/2017,1,540,625,85,1.157407407,11577,653,92
8792009665,8/4/2017,1,493,563,70,1.14198783,17318,695,79
8792009665,9/4/2017,1,426,509,83,1.194835681,17838,677,85
8792009665,10/4/2017,1,511,601,90,1.176125245,14729,696,91
8792009665,11/4/2017,1,433,495,62,1.143187067,15295,605,100
8792009665,12/4/2017,1,428,505,77,1.179906542,13834,512,74
8792009665,13/4/2017,1,452,539,87,1.192477876,12569,676,66
8792009665,14/4/2017,1,401,462,61,1.152119701,17721,561,81
8792009665,15/4/2017,1,600,670,70,1.116666667,16172,644,65
8792009665,16/4/2017,1,581,643,62,1.106712565,16311,585,99
8792009665,17/4/2017,1,535,613,78,1.145794393,14300,699,83
8792009665,18/4/2017,1,549,630,81,1.147540984,12486,676,97
8792009665,19/4/2017,1,495,584,89,1.17979798,10398,638,81
8792009665,20/4/2017,1,478,567,89,1.186192469,19270,584,86
8792009665,21/4/2017,1,481,571,90,1.187110187,17802,625,84
8792009665,22/4/2017,1,510,600,90,1.176470588,11014,645,68
8792009665,23/4/2017,1,425,504,79,1.185882353,12963,662,78
8792009665,24/4/2017,1,561,638,77,1.137254902,16644,601,79
8792009665,25/4/2017,1,454,524,70,1.154185022,14066,622,97
8792009665,26/4/2017,1,416,504,88,1.211538462,16698,554,93
8792009665,27/4/2017,1,455,522,67,1.147252747,18905,559,72
8792009665,28/4/2017,1,450,538,88,1.195555556,14453,551,73
8792009665,29/4/2017,1,494,583,89,1.180161943,19524,619,84
8792009665,30/4/2017,1,596,658,62,1.104026846,11599,636,92
8792009665,1/5/2017,1,583,667,84,1.144082333,16242,620,81
8792009665,2/5/2017,1,445,508,63,1.141573034,19767,562,61
8792009665,3/5/2017,1,405,471,66,1.162962963,14510,617,71
8792009665,4/5/2017,1,515,597,82,1.159223301,15258,670,91
8792009665,5/5/2017,1,588,652,64,1.108843537,19733,686,100
8792009665,6/5/2017,1,539,613,74,1.13729128,17491,630,70
8792009665,7/5/2017,1,465,549,84,1.180645161,17264,554,66
8792009665,8/5/2017,1,514,598,84,1.163424125,14285,681,84
8792009665,9/5/2017,1,579,659,80,1.138169257,12782,509,69
8792009665,10/5/2017,1,500,586,86,1.172,13860,614,63
8792009665,11/5/2017,1,446,527,81,1.18161435,16927,564,63
8792009665,12/5/2017,1,59,67,8,1.13559322,3072,53,25
8792009665,13/5/2017,1,379,399,20,1.052770449,2681,175,27
8792009665,14/5/2017,1,328,347,19,1.057926829,3502,99,41
8792009665,15/5/2017,1,65,73,8,1.123076923,1987,209,19
8792009665,16/5/2017,1,352,365,13,1.036931818,4168,143,13
8792009665,17/5/2017,1,383,409,26,1.067885117,4556,19,16
8792009665,18/5/2017,1,51,58,7,1.137254902,4166,175,28
8792009665,19/5/2017,1,365,371,6,1.016438356,2771,24,14
8792009665,20/5/2017,1,255,276,21,1.082352941,2515,217,1
8792009665,21/5/2017,1,205,234,29,1.141463415,2387,5,26
8792009665,22/5/2017,1,287,296,9,1.031358885,3087,185,3
8792009665,23/5/2017,1,53,66,13,1.245283019,2602,238,31
8792009665,24/5/2017,1,214,244,30,1.140186916,4847,174,23
8792009665,25/5/2017,1,57,63,6,1.105263158,4321,55,2
8792009665,26/5/2017,1,239,259,20,1.083682008,3849,93,4
8792009665,27/5/2017,1,221,243,22,1.099547511,4175,228,44
8792009665,28/5/2017,1,203,229,26,1.128078818,1583,172,34
8792009665,29/5/2017,1,89,114,25,1.280898876,1595,19,2
8792009665,30/5/2017,1,304,310,6,1.019736842,3034,53,13
8792009665,31/5/2017,1,224,234,10,1.044642857,2734,87,44
8792009665,1/6/2017,1,368,381,13,1.035326087,3867,62,28
8792009665,2/6/2017,1,307,312,5,1.016286645,1538,229,34
8792009665,3/6/2017,1,292,304,12,1.04109589,3087,180,17
8792009665,4/6/2017,1,320,331,11,1.034375,2590,178,44
8792009665,5/6/2017,1,249,269,20,1.080321285,4707,158,3
8792009665,6/6/2017,1,89,105,16,1.179775281,3064,192,22
8792009665,7/6/2017,1,190,219,29,1.152631579,4571,58,37
8792009665,8/6/2017,1,273,283,10,1.036630037,1642,135,31
8792009665,9/6/2017,1,236,262,26,1.110169492,3605,138,12
8792009665,10/6/2017,1,96,107,11,1.114583333,3695,157,18
8792009665,11/6/2017,1,251,280,29,1.115537849,1958,193,3
8792009665,12/6/2017,1,63,90,27,1.428571429,4015,135,38
8792009665,13/6/2017,1,270,282,12,1.044444444,4709,172,34
8792009665,14/6/2017,1,270,300,30,1.111111111,4948,80,1
8792009665,15/6/2017,1,189,206,17,1.08994709,4530,187,23
8792009665,16/6/2017,1,120,138,18,1.15,3571,200,0
8792009665,17/6/2017,1,282,290,8,1.028368794,4567,145,16
8792009665,18/6/2017,1,344,363,19,1.055232558,4422,131,10
8792009665,19/6/2017,1,348,368,20,1.057471264,4370,112,29
8792009665,20/6/2017,1,72,86,14,1.194444444,3736,143,0
8792009665,21/6/2017,1,136,141,5,1.036764706,3277,78,42
8792009665,22/6/2017,1,172,189,17,1.098837209,2004,17,29
8792009665,23/6/2017,1,54,76,22,1.407407407,1856,198,29
8792009665,24/6/2017,1,291,302,11,1.037800687,4414,97,17
8792009665,25/6/2017,1,231,245,14,1.060606061,2269,119,21
8792009665,26/6/2017,1,157,164,7,1.044585987,2769,207,5
8792009665,27/6/2017,1,399,404,5,1.012531328,3419,229,4
8792009665,28/6/2017,1,239,260,21,1.087866109,2663,239,6
8792009665,29/6/2017,1,205,215,10,1.048780488,3155,55,3
8792009665,30/6/2017,1,294,324,30,1.102040816,3478,105,29
8792009665,1/7/2017,1,367,377,10,1.027247956,2218,123,1
8792009665,2/7/2017,1,254,261,7,1.027559055,3423,215,31
8792009665,3/7/2017,1,243,258,15,1.061728395,2514,200,26
8792009665,4/7/2017,1,57,81,24,1.421052632,2968,237,33
8792009665,5/7/2017,1,99,122,23,1.232323232,3748,237,17
8792009665,6/7/2017,1,372,399,27,1.072580645,2099,136,16
8792009665,7/7/2017,1,383,389,6,1.015665796,2616,27,13
8792009665,8/7/2017,1,328,341,13,1.039634146,4244,101,15
8792009665,9/7/2017,1,267,275,8,1.029962547,4212,99,9
8792009665,10/7/2017,1,340,367,27,1.079411765,4733,173,6
8792009665,11/7/2017,1,141,149,8,1.056737589,2025,162,22
8792009665,12/7/2017,1,332,345,13,1.039156627,1702,144,33
8792009665,13/7/2017,1,390,411,21,1.053846154,1823,175,28
8792009665,14/7/2017,1,348,362,14,1.040229885,1683,45,17
8792009665,15/7/2017,1,236,262,26,1.110169492,2594,51,42
8792009665,16/7/2017,1,198,222,24,1.121212121,4170,199,38
8792009665,17/7/2017,1,259,273,14,1.054054054,4039,20,21
8792009665,18/7/2017,1,343,353,10,1.029154519,2377,151,23
8792009665,19/7/2017,1,273,292,19,1.06959707,4783,235,4
8792009665,20/7/2017,1,247,264,17,1.068825911,2260,214,26
8792009665,21/7/2017,1,240,251,11,1.045833333,3448,117,40
8792009665,22/7/2017,1,277,282,5,1.018050542,1625,65,22
8792009665,23/7/2017,1,284,305,21,1.073943662,2777,175,24
8792009665,24/7/2017,1,226,236,10,1.044247788,3512,146,2
8792009665,25/7/2017,1,231,255,24,1.103896104,3908,12,43
8792009665,26/7/2017,1,258,274,16,1.062015504,2846,169,21
8792009665,27/7/2017,1,306,333,27,1.088235294,1773,46,35
8792009665,28/7/2017,1,99,128,29,1.292929293,4851,90,4
8792009665,29/7/2017,1,392,401,9,1.022959184,4697,137,11
8792009665,30/7/2017,1,223,241,18,1.080717489,4188,183,42
8792009665,31/7/2017,1,126,147,21,1.166666667,2293,202,33
8792009665,1/8/2017,1,326,334,8,1.024539877,4552,190,38
8792009665,2/8/2017,1,116,132,16,1.137931034,3264,163,17
8792009665,3/8/2017,1,294,322,28,1.095238095,3602,127,12
8792009665,4/8/2017,1,82,102,20,1.243902439,3758,236,5
8792009665,5/8/2017,1,108,123,15,1.138888889,3707,230,29
8792009665,6/8/2017,1,175,195,20,1.114285714,3333,209,45
8792009665,7/8/2017,1,160,183,23,1.14375,3307,98,16
8792009665,8/8/2017,1,351,380,29,1.082621083,4040,127,6
8792009665,9/8/2017,1,350,355,5,1.014285714,1547,224,22
8792009665,10/8/2017,1,170,187,17,1.1,1877,165,34
8792009665,11/8/2017,1,176,200,24,1.136363636,4346,82,39
8792009665,12/8/2017,1,55,71,16,1.290909091,4005,127,2
8792009665,13/8/2017,1,391,405,14,1.035805627,1501,49,21
8792009665,14/8/2017,1,179,202,23,1.12849162,3645,13,23
8792009665,15/8/2017,1,230,239,9,1.039130435,4550,77,27
8792009665,16/8/2017,1,205,213,8,1.03902439,1543,153,35
8792009665,17/8/2017,1,258,275,17,1.065891473,4960,4,6
8792009665,18/8/2017,1,64,77,13,1.203125,2627,66,10
8792009665,19/8/2017,1,308,335,27,1.087662338,2706,76,47
8792009665,20/8/2017,1,344,350,6,1.01744186,4348,178,45
8792009665,21/8/2017,1,54,111,57,2.055555556,7790,236,54
8792009665,22/8/2017,1,203,235,32,1.157635468,7147,352,49
8792009665,23/8/2017,1,52,86,34,1.653846154,7211,265,49
8792009665,24/8/2017,1,264,312,48,1.181818182,5199,441,51
8792009665,25/8/2017,1,290,336,46,1.15862069,7511,295,57
8792009665,26/8/2017,1,249,303,54,1.21686747,6801,257,45
8792009665,27/8/2017,1,81,140,59,1.728395062,8430,334,50
8792009665,28/8/2017,1,317,350,33,1.104100946,8973,325,56
8792009665,29/8/2017,1,184,219,35,1.190217391,7707,500,55
8792009665,30/8/2017,1,199,257,58,1.291457286,5483,455,56
8792009665,31/8/2017,1,140,179,39,1.278571429,5514,489,49
8792009665,1/9/2017,1,134,167,33,1.246268657,8754,243,60
8792009665,2/9/2017,1,364,415,51,1.14010989,9331,249,59
8792009665,3/9/2017,1,54,103,49,1.907407407,5322,330,51
8792009665,4/9/2017,1,288,339,51,1.177083333,9686,261,58
8792009665,5/9/2017,1,364,407,43,1.118131868,8818,418,53
8792009665,6/9/2017,1,173,225,52,1.300578035,7060,440,47
8792009665,7/9/2017,1,113,160,47,1.415929204,6559,275,60
8792009665,8/9/2017,1,135,179,44,1.325925926,8071,424,58
8792009665,9/9/2017,1,264,321,57,1.215909091,8455,382,55
8792009665,10/9/2017,1,88,146,58,1.659090909,7811,426,46
8792009665,11/9/2017,1,361,407,46,1.127423823,5846,330,48
8792009665,12/9/2017,1,178,216,38,1.213483146,9361,425,60
8792009665,13/9/2017,1,241,279,38,1.157676349,9401,471,56
8792009665,14/9/2017,1,392,429,37,1.094387755,8954,278,59
8792009665,15/9/2017,1,196,227,31,1.158163265,6526,322,57
8792009665,16/9/2017,1,245,283,38,1.155102041,8403,368,52
8792009665,17/9/2017,1,165,217,52,1.315151515,5132,412,55
8792009665,18/9/2017,1,189,230,41,1.216931217,8076,464,60
8792009665,19/9/2017,1,227,262,35,1.154185022,5610,369,52
8792009665,20/9/2017,1,153,212,59,1.385620915,9102,311,50
8792009665,21/9/2017,1,369,401,32,1.086720867,5708,334,52
8792009665,22/9/2017,1,134,189,55,1.410447761,5548,357,53
8792009665,23/9/2017,1,328,375,47,1.143292683,8601,489,51
8792009665,24/9/2017,1,70,130,60,1.857142857,8818,403,54
8792009665,25/9/2017,1,201,242,41,1.2039801,5920,441,51
8792009665,26/9/2017,1,267,322,55,1.205992509,5737,421,48
8792009665,27/9/2017,1,396,435,39,1.098484848,6247,475,52
8792009665,28/9/2017,1,126,182,56,1.444444444,9013,288,57
8792009665,29/9/2017,1,295,335,40,1.13559322,7492,487,45
8792009665,30/9/2017,1,163,208,45,1.27607362,7402,425,58
8792009665,1/10/2017,1,105,160,55,1.523809524,6610,448,58
8792009665,2/10/2017,1,337,388,51,1.151335312,6074,486,50
8792009665,3/10/2017,1,123,167,44,1.357723577,7937,327,49
8792009665,4/10/2017,1,160,219,59,1.36875,8759,366,45
8792009665,5/10/2017,1,79,139,60,1.759493671,6498,381,52
8792009665,6/10/2017,1,143,174,31,1.216783217,8076,259,52
8792009665,7/10/2017,1,185,223,38,1.205405405,9471,370,57
8792009665,8/10/2017,1,348,388,40,1.114942529,7682,428,60
8792009665,9/10/2017,1,146,202,56,1.383561644,8494,436,54
8792009665,10/10/2017,1,132,184,52,1.393939394,7738,379,58
8792009665,11/10/2017,1,268,320,52,1.194029851,6075,469,48
8792009665,12/10/2017,1,353,406,53,1.150141643,7763,480,53
8792009665,13/10/2017,1,117,155,38,1.324786325,8263,451,45
8792009665,14/10/2017,1,129,170,41,1.317829457,9020,401,48
8792009665,15/10/2017,1,69,119,50,1.724637681,5406,289,47
8792009665,16/10/2017,1,152,193,41,1.269736842,6251,451,57
8792009665,17/10/2017,1,252,312,60,1.238095238,6807,312,51
8792009665,18/10/2017,1,242,298,56,1.231404959,9549,425,55
8792009665,19/10/2017,1,187,235,48,1.256684492,9737,374,52
8792009665,20/10/2017,1,127,165,38,1.299212598,5467,394,56
8792009665,21/10/2017,1,141,189,48,1.340425532,8630,380,51
8792009665,22/10/2017,1,280,325,45,1.160714286,8595,383,57
8792009665,23/10/2017,1,82,137,55,1.670731707,6540,269,51
8792009665,24/10/2017,1,359,416,57,1.158774373,9908,374,50
8792009665,25/10/2017,1,290,329,39,1.134482759,9521,303,49
8792009665,26/10/2017,1,123,155,32,1.260162602,5398,404,58
8792009665,27/10/2017,1,98,141,43,1.43877551,9653,395,54
8792009665,28/10/2017,1,283,340,57,1.201413428,7107,436,49
8792009665,29/10/2017,1,217,266,49,1.225806452,6839,378,56
8792009665,30/10/2017,1,194,247,53,1.273195876,5449,293,49
8792009665,31/10/2017,1,103,147,44,1.427184466,6134,242,55
8792009665,1/11/2017,1,282,319,37,1.131205674,6292,414,52
8792009665,2/11/2017,1,329,381,52,1.158054711,5684,401,58
8792009665,3/11/2017,1,312,368,56,1.179487179,7734,489,50
8792009665,4/11/2017,1,98,150,52,1.530612245,7139,356,47
8792009665,5/11/2017,1,179,211,32,1.17877095,5016,268,59
8792009665,6/11/2017,1,360,405,45,1.125,6342,305,57
8792009665,7/11/2017,1,178,224,46,1.258426966,9084,301,60
8792009665,8/11/2017,1,112,150,38,1.339285714,8087,254,55
8792009665,9/11/2017,1,251,295,44,1.175298805,5236,374,45
8792009665,10/11/2017,1,103,142,39,1.378640777,6737,378,55
8792009665,11/11/2017,1,93,127,34,1.365591398,7476,330,60
8792009665,12/11/2017,1,247,302,55,1.222672065,9395,326,52
8792009665,13/11/2017,1,317,355,38,1.119873817,6754,308,57
8792009665,14/11/2017,1,183,236,53,1.289617486,8381,312,58
8792009665,15/11/2017,1,198,252,54,1.272727273,9570,342,53
8792009665,16/11/2017,1,183,224,41,1.224043716,8888,257,57
8792009665,17/11/2017,1,280,316,36,1.128571429,7569,451,51
8792009665,18/11/2017,1,119,156,37,1.31092437,5527,398,50
8792009665,19/11/2017,1,311,347,36,1.115755627,8787,443,59
8792009665,20/11/2017,1,154,209,55,1.357142857,5722,250,46
8792009665,21/11/2017,1,388,439,51,1.131443299,7406,247,49
8792009665,22/11/2017,1,290,322,32,1.110344828,9768,382,49
8792009665,23/11/2017,1,97,152,55,1.567010309,9005,365,59
8792009665,24/11/2017,1,215,265,50,1.23255814,8379,407,56
8792009665,25/11/2017,1,337,397,60,1.178041543,7651,281,48
8792009665,26/11/2017,1,98,147,49,1.5,6338,420,51
8792009665,27/11/2017,1,244,277,33,1.135245902,5259,241,47
8792009665,28/11/2017,1,285,333,48,1.168421053,5769,439,82
8792009665,29/11/2017,1,320,367,47,1.146875,7976,673,61
8792009665,30/11/2017,1,149,199,50,1.33557047,17586,619,87
8792009665,1/12/2017,1,218,316,98,1.449541284,13815,676,67
8792009665,2/12/2017,1,245,314,69,1.281632653,12135,507,76
8792009665,3/12/2017,1,314,397,83,1.26433121,14314,683,94
8792009665,4/12/2017,1,51,141,90,2.764705882,10937,545,99
8792009665,5/12/2017,1,380,442,62,1.163157895,10763,605,86
8792009665,6/12/2017,1,300,399,99,1.33,14322,540,87
8792009665,7/12/2017,1,381,450,69,1.181102362,16019,699,94
8792009665,8/12/2017,1,195,287,92,1.471794872,18869,551,96
8792009665,9/12/2017,1,261,325,64,1.245210728,16008,545,99
8792009665,10/12/2017,1,213,306,93,1.436619718,11969,647,65
8792009665,11/12/2017,1,354,454,100,1.282485876,17753,598,81
8792009665,12/12/2017,1,209,301,92,1.440191388,16342,692,84
8792009665,13/12/2017,1,181,257,76,1.419889503,12652,699,77
8792009665,14/12/2017,1,324,423,99,1.305555556,12277,699,88
8792009665,15/12/2017,1,352,449,97,1.275568182,13649,505,87
8792009665,16/12/2017,1,249,318,69,1.277108434,10578,619,65
8792009665,17/12/2017,1,273,361,88,1.322344322,14234,543,70
8792009665,18/12/2017,1,208,272,64,1.307692308,18631,531,86
8792009665,19/12/2017,1,194,282,88,1.453608247,11099,668,98
8792009665,20/12/2017,1,354,433,79,1.223163842,18006,660,98
8792009665,21/12/2017,1,383,452,69,1.180156658,12850,679,65
8792009665,22/12/2017,1,281,354,73,1.259786477,12122,696,78
8792009665,23/12/2017,1,292,362,70,1.239726027,18034,540,87
8792009665,24/12/2017,1,100,189,89,1.89,11821,691,75
8792009665,25/12/2017,1,352,444,92,1.261363636,14234,610,79
8792009665,26/12/2017,1,227,289,62,1.273127753,10603,666,91
8792009665,27/12/2017,1,94,180,86,1.914893617,10023,593,75
8792009665,28/12/2017,1,237,325,88,1.371308017,17763,684,70
8792009665,29/12/2017,1,160,243,83,1.51875,15801,676,77
8792009665,30/12/2017,1,207,273,66,1.31884058,19779,668,92
8792009665,31/12/2017,1,288,376,88,1.305555556,12251,592,98
8792009665,1/1/2018,1,104,201,97,1.932692308,18951,586,89
8792009665,2/1/2018,1,333,408,75,1.225225225,14277,599,80
8792009665,3/1/2018,1,314,393,79,1.251592357,14294,504,100
8792009665,4/1/2018,1,80,158,78,1.975,18324,560,85
8792009665,5/1/2018,1,381,444,63,1.165354331,16804,588,64
8792009665,6/1/2018,1,276,356,80,1.289855072,15357,541,79
8792009665,7/1/2018,1,364,427,63,1.173076923,18020,526,96
8792009665,8/1/2018,1,138,210,72,1.52173913,15196,512,98
8792009665,9/1/2018,1,111,184,73,1.657657658,13901,539,94
8792009665,10/1/2018,1,82,181,99,2.207317073,19038,625,95
8792009665,11/1/2018,1,279,374,95,1.340501792,11831,634,89
8792009665,12/1/2018,1,249,344,95,1.381526104,11055,529,83
8792009665,13/1/2018,1,214,306,92,1.429906542,16432,566,98
8792009665,14/1/2018,1,273,339,66,1.241758242,10763,501,87
8792009665,15/1/2018,1,387,466,79,1.204134367,14037,657,85
8792009665,16/1/2018,1,386,448,62,1.160621762,10916,577,98
8792009665,17/1/2018,1,372,436,64,1.172043011,18391,581,72
8792009665,18/1/2018,1,80,159,79,1.9875,10335,631,63
8792009665,19/1/2018,1,392,458,66,1.168367347,13331,520,83
8792009665,20/1/2018,1,95,162,67,1.705263158,12893,641,69
8792009665,21/1/2018,1,399,493,94,1.235588972,17042,563,68
8792009665,22/1/2018,1,276,368,92,1.333333333,17633,591,96
8792009665,23/1/2018,1,313,374,61,1.194888179,16646,611,73
8792009665,24/1/2018,1,228,296,68,1.298245614,16634,534,92
8792009665,25/1/2018,1,82,167,85,2.036585366,19333,636,89
8792009665,26/1/2018,1,294,365,71,1.241496599,16654,597,69
8792009665,27/1/2018,1,319,402,83,1.260188088,14594,670,92
8792009665,28/1/2018,1,128,197,69,1.5390625,14255,556,66
8792009665,29/1/2018,1,143,234,91,1.636363636,11927,694,87
8792009665,30/1/2018,1,231,306,75,1.324675325,17103,511,66
8792009665,31/1/2018,1,104,201,97,1.932692308,15349,505,82
8792009665,1/2/2018,1,186,262,76,1.408602151,13238,565,65
8792009665,2/2/2018,1,222,314,92,1.414414414,13306,566,87
8792009665,3/2/2018,1,347,423,76,1.219020173,15838,671,97
8792009665,4/2/2018,1,333,433,100,1.3003003,13725,614,66
8792009665,5/2/2018,1,57,131,74,2.298245614,10245,633,63
8792009665,6/2/2018,1,392,475,83,1.211734694,15005,546,68
8792009665,7/2/2018,1,288,379,91,1.315972222,18817,604,76
8792009665,8/2/2018,1,324,388,64,1.197530864,16008,520,85
8792009665,9/2/2018,1,344,426,82,1.238372093,14555,509,78
8792009665,10/2/2018,1,199,287,88,1.442211055,10446,676,68
8792009665,11/2/2018,1,219,295,76,1.347031963,17910,533,82
8792009665,12/2/2018,1,135,223,88,1.651851852,12648,685,81
8792009665,13/2/2018,1,150,227,77,1.513333333,19938,674,95
8792009665,14/2/2018,1,368,448,80,1.217391304,14083,514,66
8792009665,15/2/2018,1,244,327,83,1.340163934,15910,519,96
8792009665,16/2/2018,1,65,137,72,2.107692308,10313,532,61
8792009665,17/2/2018,1,111,174,63,1.567567568,14157,682,64
8792009665,18/2/2018,1,379,453,74,1.19525066,10598,605,99
8792009665,19/2/2018,1,95,186,91,1.957894737,17386,594,64
8792009665,20/2/2018,1,189,251,62,1.328042328,11986,666,74
8792009665,21/2/2018,1,210,287,77,1.366666667,16040,631,100
8792009665,22/2/2018,1,275,345,70,1.254545455,13742,505,90
8792009665,23/2/2018,1,181,246,65,1.359116022,12651,532,78
8792009665,24/2/2018,1,225,293,68,1.302222222,18822,552,74
8792009665,25/2/2018,1,304,382,78,1.256578947,11025,529,92
8792009665,26/2/2018,1,211,283,72,1.341232227,17091,616,88
8792009665,27/2/2018,1,184,266,82,1.445652174,17036,630,73
8792009665,28/2/2018,1,389,470,81,1.208226221,10287,605,67
8792009665,1/3/2018,1,155,244,89,1.574193548,17501,511,83
8792009665,2/3/2018,1,269,354,85,1.31598513,14456,662,98
8792009665,3/3/2018,1,381,469,88,1.230971129,17917,619,62
8792009665,4/3/2018,1,322,409,87,1.270186335,19746,505,91
8792009665,5/3/2018,1,348,424,76,1.218390805,17844,552,74
8792009665,6/3/2018,1,331,397,66,1.19939577,15978,510,69
8792009665,7/3/2018,1,337,401,64,1.189910979,17486,537,91
8792009665,8/3/2018,1,80,156,76,1.95,11080,564,78